Notable Loot Changes:
	Trufflemunch - Add Mincemeat's item pool.
	Buttmunch - Add Mincemeat's item pool.
	Rohner - Add Red Rain's loot pool.
	Road Dog - Add a 50% chance to drop a purple Atlas grenade.
	Tink Train - Add a 75% chance to drop a purple Vladof grenade.
	Lagromar -  Add a 75% chance to drop a purple Torgue grenade.
	Manvark - Add the Hunt(er) to Manvark's Loot Pool.
	Crushjaw - Add a 75% chance to drop a purple Tediore grenade.
	Crushjaw - Add Rachel's item pool.
	Tyreen the Destroyer - Add the Bekah and Superstreamer.
	Tyreen the Destroyer - Add Brood Mother's item pool.
	Gigamind - Add the Null-Pointer and Vault Hero.
	Private Beans - Add the Boo.
	Rampager - Add the Cloud Kill and Quadomizer.
	Rampager - Remove the Duc.
	Dreg - Add the Duc.
	Indo Tyrant - Add Artemis' dedicated items.
	Turnkey Tim - Add Muldock's dedicated items.
	Muldock the Anointed - Add the Hand of Glory.
	GenIVIV - Add the Messy Breakup.
	GenIVIV - Remove the Ten Gallon.
	Rax - Add the Ten Gallon.
	King Gnasher - Add Blue Fire's pool.
	King Gnasher - Remove Westergun.
	Graveward - Add the Earworm.
	Blinding Banshee - Add a 75% chance to drop a purple Hyperion grenade.
	Sylestro - Add the Vibra-Pulse.
	Preston - Add a 75% chance to drop a purple Pangolin grenade.
	Golden Bullion - Add All-In.
	EVIL Saint Lawrence - Add Just Kaus.
	Tricksy Nick - Add Robo-Melter Masher.
	Stanley - Add Ember's Blaze.
	DEGEN-3 - Add Acid Burn.
	Rudy Varlope - Add La Varlope.
	Gorgeous Armada - Add Double Downer.
	Toby Bordell - Add Brad Luck.
	Fabricator - Add Melt-Facer.
	Loco Chantelle - Add Ember's Purge.
	Freddie - Add the Scoville.
	Jack-bot - Add Rico.
	Yeti - Add Short Stick.
	Eista - Add the Sacrificial Lamb.
	Eista - Remove Skullmasher.
	Kritchy - Add the Cure.
	Amach - Add Initiative.
	Gmork - Add Cocky Bastard.
	Wendigo - Add Seventh Sense.
	Kukuwajack - Add the Skullmasher.
	Kratch - Add the Pearl of Knowledge.
	Eleanor and the Heart - Add Firecracker and the non-Legendary Love Drill.
	Adelai Bronson - Add Peashooter.
	Ipswitch Dunne - Add Quickdraw.
	Doc Stanley - Add Doc Hina's Miracle Bomb.
	Lani Dixon - Add the Chalice.
	Haddon Marr - Add Bubble Blaster.
	Kormash - Add Vendetta to Kormash.
	Lasodactyl - Add Icebreaker to Lasodactyl.
	Lectrikor - Add the Beast(s) to Lectrikor.
	Bellik Primis - Add Core Buster.
	Quartermaster - Add Splinter.
	Ruiner - Add Dakota.
	Spongeboss - Remove the P.A.T. Mk. III.
	General Blisterpus - Added the P.A.T. Mk. III.
	Gravekeeper - Add the Company Man.
	The Seer - Add Mysterious Amulet.
	Loot-o'-Gram - Butcher and Lucian's Call replaced with a chance at a drop from the Slaughter Bosses.
	
	
	
	
	
	
	